00 00 00 00 00 00 00 00 00 
00 01 02 03 04 00 00 00 00 
00 05 06 07 08 00 00 00 00 
00 09 10 11 12 00 17 00 00 
00 13 14 15 00 00 00 00 00
00 00 00 00 00 00 00 00 00 

